NO ./imgs/north.xpm

SO ./imgs/south.xpm
WE   ./imgs/west.xpm
EA                ./imgs/east.xpm
F                    220,100,0
C 225,     30,1

        1111111111111111111111111
        100000000011000000S000001
        1011000001110000000000001
        1001000000000000000000001
111111111011000001110000000000001
100000000011000001110001111111111
1111011111011101000000000001
1111011111011101110101000001
1100000011010101110000000001
1000000000000000000000000001
10000000000000001101010000011
110000011101010111110111100111
11110111 1110101 101111010001 
11111111 1111111 111111111111
