NO ./imgs/north.xpm
SO ./imgs/south.xpm
WE   ./imgs/west.xpm
EA ./imgs/east.xpm
F 0,0,0
C 255,0,0

1111111111111111111111111
1000000000110000000000001
10110000011100N0000000011
1111111111111111111111111
  111              111
1111111111111111111111111