NO north.xpm
SO south.xpm
WE west.xpm
EA east.xpm
F 220,1,2
C 0,1,0



1111111111111111111111111
1000000000110000000000001
101100000111000000N000011
1111111111111111111111111