NO ./imgs/north.xpm
SO ./imgs/south.xpm
WE   ./imgs/west.xpm
EA ./imgs/east.xpm


         F 0         ,          0          ,         0                  



C 255,1,0

1111111111111111111111111
1000000000110000000000001
1011000001110N000000001111
10000000000000000000000001
10000000001100000000000011
1000000000110000000000001
1000000000110000000000001
1000000000110000000000001
1000000000110000000000001
1000000000110000000000001
1000000000110000000000001
1000000000110000000000001
1000000000110000000000001
1000000000110000000000001
1000000000110000000000001
1000000000110000000000001
1000000000110000000000001
1000000000110000000000001
1000000000110000000000001
1000000000110000000000001
1000000000110000000000001
1000000000110000000000001
1000000000110000000000001
1000000000110000000000001
1000000000110000000000001
1000000000110000000000001
1000000000110000000000001
1000000000110000000000001
1000000000110000000000001
1000000000110000000000001
1000000000110000000000001
1000000000110000000000001
1000000000110000000000001
1000000000110000000000001
1000000000110000000000001
1000000000110000000000001
1000000000110000000000001
1000000000110000000000001
1000000000110000000000001
1000000000110000000000001
1000000000110000000000001
1000000000110000000000001
1000000000110000000000001
1000000000110000000000001
1000000000110000000000001
1000000000110000000000001
1000000000110000000000001
1000000000110000000000001
1000000000110000000000001
1000000000110000000000001
1000000000110000000000001
1000000000110000000000001
1000000000110000000000001
1000000000110000000000001
1000000000110000000000001
1000000000110000000000001
1000000000110000000000001
1000000000110000000000001
1000000000110000000000001
1000000000110000000000001
1000000000110000000000001
1000000000110000000000001
1000000000110000000000001
1000000000110000000000001
1000000000110000000000001
1000000000110000000000001
1000000000110000000000001
1000000000110000000000001
1000000000110000000000001
1000000000110000000000001
1000000000110000000000001
1000000000110000000000001
1000000000110000000000001
1000000000110000000000001
1000000000110000000000001
1000000000110000000000001
1000000000110000000000001
1000000000110000000000001
1000000000110000000000001
1000000000110000000000001
1000000000110000000000001
1000000000110000000000001
1000000000110000000000001
1000000000110000000000001
1000000000110000000000001
1000000000110000000000001
1000000000110000000000001
1000000000110000000000001
1000000000110000000000001
1000000000110000000000001
1000000000110000000000001
1000000000110000000000001
1000000000110000000000001
1000000000110000000000001
1000000000110000000000001
1000000000110000000000001
1000000000110000000000001
1000000000110000000000001
1000000000110000000000001
1000000000110000000000001
1000000000110000000000001
1000000000110000000000001
1000000000110000000000001
1000000000110000000000001
1000000000110000000000001
1000000000110000000000001
1000000000110000000000001
1000000000110000000000001
1000000000110000000000001
1000000000110000000000001
1000000000110000000000001
1000000000110000000000001
1000000000110000000000001
1000000000110000000000001
1000000000110000000000001
1000000000110000000000001
1000000000110000000000001
1000000000110000000000001
1000000000110000000000001
1000000000110000000000001
1000000000110000000000001
1000000000110000000000001
1000000000110000000000001
1000000000110000000000001
1000000000110000000000001
1000000000110000000000001
1000000000110000000000001
1000000000110000000000001
1000000000110000000000001
1000000000110000000000001
1000000000110000000000001
1000000000110000000000001
1000000000110000000000001
1000000000110000000000001
1000000000110000000000001
1000000000110000000000001
1000000000110000000000001
1000000000110000000000001
1000000000110000000000001
1000000000110000000000001
1000000000110000000000001
1000000000110000000000001
1000000000110000000000001
1000000000110000000000001
1000000000110000000000001
1000000000110000000000001
1000000000110000000000001
1000000000110000000000001
1000000000110000000000001
1111111111111111111111111
  111              111
1111111111111111111111111