NO ./imgs/north.xpm
WE   ./imgs/west.xpm
SO ./imgs/south.xpm
EA ./imgs/east.xpm
DO ./imgs/iron_door.xpm

F 124, 252,0

C 0, 175,255


1111111111111111111111111
1000000000110000000000001
1011000001110000000000001
1001000000020000000000001111
111111111211000001110000000111111
100000000011000001110111112111111
11110111111111011100000010001
11112111111111211101010010001
11000000110101011100000020001
10000000000000000200000010001
10000000000000001101010010001
11000001110101011111011110N0111
11110111 1110101 101111010001
11111111 1111111 111111111111