NO ./imgs/north.xpm
WE   ./imgs/west.xpm
SO ./imgs/south.xpm
EA ./imgs/east.xpm
DO ./imgs/door.xpm

F 220,100,0
C 225,30,1

1111111111111111111111111
1000000000110000000000001
1011000001110000000000001
1001000000020000000000001
111111111211000001110000111111111
100000000011000001110111111111111
11110111111111011100000010001
11112111111111211101010020001
11000000110101011100000010001
10000000000000000200000010001
10000000000000001101010010001
11000001110101011111011110N0111
11110111 1110101 101111010001
11111111 1111111 111111111111