NO ./imgs/north.xpm
WE   ./imgs/west.xpm
SO ./imgs/south.xpm
EA ./imgs/east.xpm 

F 124, 252,0

C 111, 175,      255

1111111111111111111111111
1000000000110000000000001
1011000001110000000000001
1001000000010000000000001111
111111111111000001110000000111111
100000000011000001110111111111111111111
11110111111111011100000010001         1
11111111111111111101010010001         1   1
11000000110101011100000000001 1   1   1
100000000000000001000000100011        1
10000000000000001101010010001         1
11000001110101011111011110N011111111111
11110111 1110101 101111010001
11111111 1111111 111111111111
  
1111111111111111111111111
1000000000110000000000001
1011000001110000000000001
1001000000010000000000001111
111111111111000001110000000111111
100000000011000001110111111111111
11110111111111011100000010001
11111111111111111101010010001
11000000110101011100000000001
10000000000000000100000010001
10000000000000001101010010001
1100000111010101111101111000111
11110111 1110101 101111010001
11111111 1111111 111111111111
