NO ./imgs/north.xpm
WE   ./imgs/west.xpm
SO ./imgs/south.xpm
EA ./imgs/east.xpm
DO ./imgs/iron_door.xpm

F 124, 252,0

C 0, 175,255


11111111111111111111111111111
10000000002001000020000200001
10110010011101111111111111101
10010010000201000000000000001
111111111211010001110000000011111
100000000011000001110111112111111
11110111111111011100000010001
11112111111111211101010010001
10020000110101011100000020001
10011211100000000201212110201
10010000000000001101010010001
11010001110121211111011110N0111
11112111 1110101 101111010001
11111111 1111111 111111111111