NO ./imgs/north.xpm
WE   ./imgs/west.xpm
SO ./imgs/south.xpm
EA ./imgs/east.xpm
DO ./imgs/iron_door.xpm

F 124, 252,0

C 0, 175,255
11111
10001
10001
10001
10001
10001
10001
10001
10001
10001
10001
10001
10001
10001
10001
10001
10001
10001
11211
11N11
11111
11111
